1111111111
1P000100C1
11110001C1
1E00001111
111C100C11
1111111111