1111111111
1PCCCCCCC1
111CCCCCC1
1ECCCCCCC1
1111111111