11111111111111111111
1P00000000000000C001
1E000000011000000001
10000000010000000001
10000000011000000001
11111111111111111111