11111111
1P000001
10000001
10000111
1E0000C1
11111111
