1111111111
1PCE100001
1111110001
1000000001
1111111111