1111111111111
1011111001011
100000P111011
1CCE100000011
1000000000001
1000CCC001001
1111111111111
