11111111111111111111
1EC00000000000000001
1CC00000000000000001
10000000000000000001
10000000000000000001
10000000000000000001
10000000000000000001
10000000000000000001
100000000000000000P1
11111111111111111111
